000000000000000000000000000
0AAAAAAAAAAAAAAAAAAAAAAAAA0
0AAAAAAAAAAAAAAAAAAAAAAAAA0
0AAAAAAAAAAAAAAAAAAAAAAAAA0
0AAAAAAAAAAAAAAAAAAAAAAAAA0
0AAAAAAAAAAAAAAAAAAAAAAAAA0
0000000AAAA00AAAAAAAAAAAAA0
0000000AAAA00AAAAAAAAAAAAA0
0000000AAAA00AAAAAAAAAAAAA0
0000000AAAA00AAAAAAAAAAAAA0
0000000AAAA0000000000000000