000000000000000000000000000000000000000000000000000000
055555555555555555555555555555555555555555555555555550
050000000000500000000000000000000000000000000000000050
050000000000500000000000000000000000000000000000000050
050000000000500000000000000000000000000000000000000050
050000000000500000000000000000000000000000000000000050
050000000000000000000000000000000000000000000000000050
050000000000000000000000000000000000000000000000000050
050000000000500000000000000000000000000000000000000050
050000000000500000000000000000000000000000000000000050
050000000000500000000000000000000000000000000000000050
050000000000500000000000000000000000000000000000000050
055555555555550000000055550000000000000000000000000050
000000000000050000000050050000000000000000000000000050
000000000000050000000050050000000000000000000000000050
000000000000050000000050050000000000000000000000000050
000000000000050000000050050000000000000000000000000050
000000000000050000000050050000000000000000000000000050
000000000000050000000050050000000000000000000000000050
000000000000050000000050055555555555555555555555555550
000000000000050000000050000000000000000000000000000000
000000000000050000000050000000000000000000000000000000
000000000000055555555550000000000000000000000000000000
000000000000000000000000000000000000000000000000000000