0000000000000000000000000000000000000000
0000000000000000000000000000000000000000
0044444444444444444444444444444444444400
0040000000000000000000000000000000000400
0040000000000000000000000000000000000400
0040000000000000000000000000000000000400
0040000000000000000000000000000000000400
0040000000000000000000000000000000000400
0040000000000000000000000000000000000400
0040000000000000000000000000000000000400
0040000000000000000000000000000000000400
0040000000000000000000000000000000000400
0040000000000000000000000000000000000400
0040000000000000000000000000000000000400
0040000000000000000000000000000000000400
0040000000000000000000000000000000000400
0040000000000000000000000000000000000400
0040000000000000000000000000000000000400
0040000000000000000000000000000000000400
0040000000000000000000000000000000000400
0040000000000000000000000000000000000400
0040000000000000000000000000000000000400
0040000000000000000000000000000000000400
0040000000000000000000000000000000000400
0040000000000000000000000000000000000400
0040000000000000000000000000000000000400
0040000000000000000000000000000000000400
0044444444444444444444444444444444444400
0000000000000000000000000000000000000000
0000000000000000000000000000000000000000